{
	"chunk_size":[8,8],
	"tiles":[
		[
			1,5,0,0,0,0,0,0,
			0,1,0,0,0,0,0,0,
			0,1,4,0,0,0,0,0,
			0,1,1,1,4,0,1,0,
			0,0,0,0,3,0,0,0,
			0,0,0,0,0,1,0,0,
			0,0,0,0,0,0,2,1,
			0,0,0,0,0,0,3,1
		]
	],
	"tiledata":[
		{
			"storage":[],
			"direction":[
				0,0,0,0,0,0,0,0,
				0,0,0,0,0,0,0,0,
				0,0,0,0,0,0,0,0,
				0,0,0,0,0,0,0,0,
				0,0,0,0,0,0,0,0,
				0,0,0,0,0,0,0,0,
				0,0,0,0,0,0,0,0,
				0,0,0,0,0,0,0,0
			]
		}
	]
}
